G G M M M M M M M M M M M M M M M M M M M M M M M M M M M
G G G G G G G G G G G G G G G G G G G G G G G G G G G G M
M G G G G G G G G G G G G G G G G G G G G G G G G G G G M
M G G G G G G G G G G G G G G G G G G G G G G G G G G G M
M G G G G G G G G G G G G G G G G G G G G G G G G G G G M
M G G G G G G G G G G G G G G G G G G G G G G G G G G G M
M G G G G G G G G W G W G G G G G G G G G G G G G G G G M
M G G G G G G G G W W W G G G G G G G G G G M M G G G G M
M G G G G G G G G W W W G G G G G G G G G G M M G G G G M
M G G G G G G G G G W W W G G G G G G G G G G G G G G G M
M G G G G G G G G G G W W W G G G G G G G G G G G G G G M
M G G G G G G G G G G G G G G G G G G G G G G G G G G G M
M G G G G G G G G G G W W W G G G G G G G G G G G G G G M
M G G G G G G G G G W W W W W G G G G G G G G G G G G G M
M G G G G G G G G W W W G G W W G G G G G G P P P G G G M
M G G G G G G G G W W G G G W W G G G G G G P P P G G G M
M G G G G G G G G G W W G W W G G G G G G G P P P G G G M
M G G G G G G G G G G W W W G G G G G G G G G G G G G G M
M G G G G G G G G G G G G G G G G G G G G G G G G G G G M
M G G G G G G G G G G G G G G G G G G G G G G G G G G G M
M M M M M M M M M M M M M M M M M M M M M M M M M M M M M
