G G G G G G G G G G G G G G G G G G G G G G G G G G
G G G G G G G G G G G G G G G G G G G G G G G G G G
G G G G G G G G G G G G G G G G G G G G G G G G G G
G G G G G G G G G G G G G G G G G G G G G G G G G G
G G G G G G G G G G G G G G G G G G G G G G G G G G
G G G G G G G G W W W G G G G G G G G G G G G G G G
G G G G G G G G W W W G G G G G G G G G G R R G G G
G G G G G G G G W W W G G G G G G G G G G R R G G G
G G G G G G G G G W W W G G G G G G G G G G G G G G
G G G G G G G G G G W W W G G G G G G G G G G G G G
G G G G G G G G G G G G G G G G G G G G G G G G G G
G G G G G G G G G G W W W G G G G G G G G G G G G G
G G G G G G G G G G G W W G G G G G G G G G G G G G
G G G G G G G G G G G G G G G G G G G G G P P P G G
G G G G G G G G G G G G G G G G G G G G G P P P G G
G G G G G G G G G G G G G G G G G G G G G P P P G G
G G G G G G G G G G G G G G G G G G G G G G G G G G
G G G G G G G G G G G G G G G G G G G G G G G G G G
G G G G G G G G G G G G G G G G G G G G G G G G G G
