G G R R R R R R R R R R R R R R R R R R R R R R R R R R
G G G G H G G G G G G G G G G G G G G G G G G G G G G R
R G G G G G G G G G G G G G G G G G G G G G G G G G G R
R G G G G G G G G G G G G G G G G G G G G G G G G G G R
R G G G G G G G G G G G G G G G G G G G G G G G G G G R
R G G G G G G G G G G G G G G G G G G G G G G G G G G R
R G G G G G G G G W G W G G G G G G G G G G G G G G G R
R G G G G G G G G W W W G G G G G G G G G G R R G G G R
R G G G G G G G G W W W G G G G G G G G G G R R G G G R
R G G G G G G G G G W W W G G G G G G G G G G G G G G R
R G G G G G G G G G G W W W G G G G G G G G G G G G G R
R G G G G G G G G G G G G G G G G G G G G G G G G G G R
R G G G G G G G G G G W W W G G G G G G G G G G G G G R
R G G G G G G G G G G G W W G G G G G G G G G G G G G R
R G G G G G G G G G G G G G G G G G G G G G P P P G G R
R G G G G G G G G G G G G G G G G G G G G G P P P G G R
R G G G G G G G G G G G G G G G G G G G G G P P P G G R
R G G G G G G G G G G G G G G G G G G G G G G G G G G R
R G G G G G G G G G G G G G G G G G G G G G G G G G G R
R G G G G G G G G G G G G G G G G G G G G G G G G G G R
R R R R R R R R R R R R R R R R R R R R R R R R R R R R
